$$$1주

L1

---abduct		유괴, 납치하다.
   - The man was apprehended when he tried to abduct the child.

abominable	혐오스런, 불쾌한, 지독한
abstain		삼가다. 억제, 기권, 회피하다.
abnormal	특이한, 불규칙한, 비정상적인

---abound		풍부하다.
   - The lakes abound in fish or with fish.

L2

---abdicate	물러나다. 포기, 사임하다.
   - 

abscond	도망치다. 자취를 감추다.
avert		얼굴을 돌리다. 피하다. 막다.
abhor		혐오하다. 싫어하다.
averse		싫어하는, 반대의

L3
absolve		용서, 석방하다.
abstemious	절제하는, 검소한
abject		비참한, 비열한, 천한
ablution		목욕재계
abrogate	폐지, 철폐, 파기하다.

L4
abstruse	심오한, 난해한
avocation	부업, 취미
aberration	일탈, 탈선
abortive		실패한, 유산의, 낙태의
abrasive		신경을 거슬리는, 문질러 닦는
         	벗기는, 거친, 닳아 없애는 
		연마제
L5
acclaim		환호하다. n 환호
accommodate	ⅰ) 편의를 도모하다.
              	ⅱ) 숙박시키다.
              	ⅲ) 적응시키다. 조절하다.
acquit		무죄 석방하다. 처신, 수행하다.
adhere		-에 붙다. 충실하다.
adverse		거꾸로의, 불리한, 
		반대의, 해로운
L6
affluence	풍요, 부유
allegiance	충성, 신의
apparel		의복, 기성복 
        	v: ~을 차려입다. 입히다.
append		-에 매달다. 첨부, 첨가하다.
aspect		면, 요소, 관점, 생김새
		견해, 견지
L7
assailant	공격자
avenge		보복하다.
accelerate	가속하다. 촉진시키다. 빨라지다.
adequate	충분한, 적당한
adjacent	인접한, 이웃한
L8
advocate	옹호, 주장하다. n옹호자
affliction	고통, 고난, 불행, 질병, 재난
alliance		연합, 연맹
available	이용가능한, 유용한, 여가가 있는
accord		합의, 조화
       		vi) 일치하다. 조화되다.
       		vt) 주다. 수여하다.
L9
adapt		적응시키다. 고쳐쓰다. 
     		각색하다. 순응하다.
allot		할당하다.
annul		취소, 폐지하다.
apparition	유령
appease		달래다. 만족시키다. 양보하다.

L10
arrogance	거만, 오만
assert		주장, 단언하다.
avowed		스스로 인정한, 공인한
access		접근, 출입, 병의 발작
        	v: 입, 출력하다. ~에 접근하다.
accomplice	공범, 공범자

L11
adept		숙련된, 능숙한, 명인
adjourn		연기, 중단하다. 자리를 옮기다.
admonish	경고하다. 훈계하다.
advent		도래, 출현, 등장
aggravate	악화시키다. 화나게 하다.
L12
annexation	합병, 부가, 부가물
annihilate	전멸시키다. 폐기하다.
apportion	할당하다. 나누다.
appreciate	감사, 평가, 감상하다.
aspire		열망하다.
L13
assimilate	흡수하다. ~에 비유하다.
           	소화하다. 이해하다.
assurance	확신, 보장
accede		동의, 취임, 상속, 가입하다.
acclimate	vi) 길들다. 적응하다.
          	vt) 적응시키다. 순응시키다.
acquiesce	묵인하다. 묵묵히 따르다.

L14
adulterate	불순하게 하다.
affiliate with	vi) ~와 관계하다.
             	vt) 가입시키다. 양자로 삼다.
             	n자매회사, 가입자
alleviate		완화시키다.
allude to	~을 넌지시 언급하다. 암시하다.
appall		놀라게 하다.

L15
applicable	적용할 수 있는, 적절한
apprehensive	걱정하는, 
             	이해가 빠른, 감지하는
ascertain	확언하다. 알아내다.
assent to	동의하다.
asset		재산, 자질, 이점

2주
L16
assiduous	근면한, 정성을 다하는
attainment	성취, 학식, 재능
abase		지위를 낮추다. 실추시키다.
accentuate	강조하다. 두드러지게 하다.
accrue		서서히 늘어나다. 
		생기다. 이자 붙다.
L17
adventitious	갑작스런, 우연의
affable		붙임성 있는, 친절한
aggrandize	증대시키다. 확대,과장,강화하다.
approbation	승인
ascribe A to B	A를 B탓으로 돌리다. 
L18
aspersion	비방
assess		평가, 부과, 할당하다.
attribute A to B v) A를 B탓으로 돌리다.
                ~의 것으로 추정, 감정하다.
                n) 속성, 특질, 상징
aver		확언, 주장, 단언하다.
acquisitive	탐욕스런, 욕심이 많은
L19
affectation	가장, 허식
affront		모욕하다. 과감히 맞서다.
allege		증거 없이 주장하다. 우기다.
arrogate		사칭, 횡령하다.
asseverate	단언하다.
L20
attenuate	약화시키다. 줄이다. 소모시키다.
accolade	칭찬, 찬사
accost		~에게 말을 걸다. 접근하다.
adjudicate	판결을 내리다. 
adjunct		부가물, 조수, 보조자
L21
adumbrate	어렴풋이 나타내다. 예시하다.
affinity		유사성, 친근감, 친화력
apposite	적당한, 적절한
apprise		알리다.
attrition		소모, 마멸
L22
anecdote	일화
anonymous	익명의
abyss		심연
anarchy		무정부 상태, 혼란, 무질서
apathy		냉담, 무관심
L23
amnesty		대사, 특사, 사면, 용서
amorphous	형태가 없는, 무정형의 
            	막연한, 애매한
atrophy		영양결핍
		도덕심의 감퇴, 신체위축
         	v) 위축시키다. 위축하다.
agnostic	불가지론자
         	a) 불가지론의, 회의적인
anesthesiologist	 	마취과 의사
L24
commentary	논평, 비평, 의견, 견해
compact	v) 압축하다. 꽉 채워 넣다. 
         	a) 아담한, 꽉 짜인, 간결한
         	n) 계약, 맹약
compliant	순종하는, 고분고분한
compress	v) 압축, 요약하다.
          	n) 압박붕대
concept		개념
L25
confer		vi) 협의하다.
       		vt) 수여하다. 베풀다.
confiscate	몰수, 압수, 징발하다.
confront		직면, 당면, 대면하다.
consequence	결과, 중대성
conserve	보존, 유지하다.
L26
constrain	강제, 강요, 억제하다.
contemporary	현대의, 동시대의
convene		vi) 모이다. 
         	vt) 소집, 소화하다. 
coincide		동시에 일어나다. 일치하다.
consolidate	합병, 통합, 강화하다.
L27
conviction	유죄판결, 확산, 신념
countenance	v) 지지, 묵인하다.
             	n) 용모, 생김새, 지지, 후원
collaborate	협력하다.
commotion	소동, 폭동
congest		붐비게 하다. 충혈 시키다.
L28
convey		나르다. 운반하다. 알리다. 
combatant	a) 전투하는, 싸우는
           	n) 전투원, 교전국
commandeer	징집, 징발하다.
compensate	vi) 보충하다. 메우다. vt) 갚다.
concede	인정, 양보하다.
L29
concise		간결한, 간명한
condone	묵과, 용서하다.
congenial	같은 성질의, 취미가 같은,
		기분 좋은
console		위로하다.
conspicuous	눈에 잘 띄는
L30
contend		vi) 다투다. 겨루다. 논쟁하다.
        	vt) 주장하다.
cogent		설득력 있는
commend	칭찬하다. 위탁하다.
commodious	넓은, 편리한
compassion	연민, 동정

3주
L31
compatible	일치하는, 양립할 수 있는,적합한
comprise	이루어지다. 포함하다.
compunction	양심의 가책
conclusive	결정적인, 설득력 있는
concur		동의, 일치하다. 
		동시에 일어나다.
L32
condolence	위로, 문상
conflagration	대화재 
consecrate	신성하게 하다. 바치다. 
converge	한 점에 모이다. 수렴하다.
corrosive	신랄한, 독설적인

L33
coalition		연합, 합동
collate		대조하다.
commiserate	가엾게 여기다.
concoct		섞어 만들다. 조합하다.
         	꾸며내다. 구상하다.
conducive	도움이 되는, 공헌하는
L34
connoisseur	감정인, 품평가, 전문가
consternation	경악, 당황
contiguous	접촉하는, 이웃하는, 근처의
corroborate	확증을 주다
coherent	밀착하는, 시종일관한,
         	명확한, 이해하기 쉬운
L35
collusion	공모, 결탁
complaisant	고분고분한, 공손한, 
complement	보충
concord		일치, 조화
condign		벌, 보복이 마땅한, 응분의
L36
conjecture	짐작, 추측하다.
consign		탁송하다. 맡기다. ~을 제쳐놓다.
consummate	v) 성취, 완성하다.
             	a) 엄청난, 터무니 없는
contrite		회개하는, 잘못을 뉘우치는
conversant	정통한, 능통한, 친한
L37
convivial	즐거운, 명랑한
covenant	계약, 서약, 맹약, 협약
cognate		같은 기원의, 동족의, 
        	공통점 많은
commensurate	비례하는, 균형 잡힌
compendium	개론, 요약
L38
condescend	친히~ 해주다. 생색을 내다.
consensus	일치, 합의
constrict	압축, 제한하다. 수축 시키다.
contumacious	반항적인, 완강한
convolution	소용돌이, 뒤틀림, 우회적표현
L39
delude		속이다. 기만하다.
deluge		범람, 쇄도하다. n대홍수
depict		그리다. 서술하다.
depose		해임하다. 
designate	v) 선정, 명명, 지명, 임명하다.
          	n) 지명된
L40
deter		제지, 저지하다. 
		방해하다. 단념시키다.
detract		지위를 떨어뜨리다.
devastate	유린하다. 황폐시키다.
decrease	줄다. 감소하다. n감소
despondent	낙담한
L41
detest		혐오하다.
defect		v) 이탈, 탈출하다.
       		n) 결점, 결함
defile		더럽히다. 모독하다.
degrade		강등시키다. 타락시키다. 
deplore		한탄, 애도하다. 뉘우치다.
L42
devise		고안, 계획하다.
devoid		결핍된
depreciation	비방, 경시, 멸시
despicable	야비한, 비열한
devitalize	생명을 빼앗다. 활력을 빼앗다.
L43
decrepit		병약한, 노쇠한
defamation	명예훼손, 비방
delete		삭제하다.
demise		v) 양도하다.
        	n) 멸망, 몰락, 사망
demolition	낡은 것 파괴, 폭파 
L44
deride		비웃다. 조소하다.
destitute	빈곤한, 궁핍한
deviate		벗어나다. 이탈하다.
debase		가치를 떨어뜨리다.
decadence	도덕등의 타락, 쇠퇴
L45
deface		손상하다. 더럽히다.
deference	순종, 복종, 경의
definitive	최종적인, 결정적인
demeanor	태도, 품행
deplete		비우다, 고갈시키다.
L46
desecrate	더럽히다. 모독하다.
desist		그만두다, 중지, 단념하다.
defunct		소멸한
delectable	기쁜, 즐거운
delineate	묘사하다.
L47
delinquent	의무 태만의, 죄가있는 
           	n 비행자, 태만한 사람
deprecate	반대, 비난하다.
derelict		버려진, 황폐한
        	n 직무 태만자, 낙오자
derogatory	모욕적인
depredation	파괴, 약탈
L48
discredit		불신하다.
discretion	신중, 사려, 분별
disinterested	무관심한, 공평한, 사심없는
despatch	급송하다. 금파하다. 죽이다.
         	n 급파, 급송, 파견, 신속, 살해
disquieting	불안하게 하는, 걱정스러운
L49
dissect		해부, 분석, 비평하다.
diversity		차이, 변화
divert		전환하다. 즐겁게 하다.
dilapidated	파손된, 황폐한
diminish		줄이다. 감소시키다. 감소하다
L50
dispel		흩뜨리다. 
		분산시키다. 쫓아버리다.
disrupt		중단, 무산시키다. 
		혼란에 빠뜨리다. 분열시키다.
dissuade	설득하여 단념시키다.
disarming	안심시키는
disclaim		포기, 거절, 부인하다.
L51
disdain		경멸하다. 오만하게 굴다
        	n경멸, 멸시
divergent	서로 다른, 의견이 다른
dilate		vi) 넓어지다. 팽창하다.
      		vt) 팽창하다. 넓히다. 부연하다.
diligent		부지런한, 근면한
disentangle	vi) 풀어지다. 해결하다.
            	vt) 풀다, 해결하다.
L52
dissent		불일치, 불찬성
        	v의견을 달리하다. 반대하다.
divulge		비밀을 누설하다.
diffident		자신이 없는, 수줍어하는
discern		분별하다. 식별하다.
discrepancy	불일치, 모순
L53
disinclined	싫증나는, ~할 맘이 내키지 않는
disparage	깔보다. 헐뜯다. 비방하다.
disperse		흩뜨리다. 쫓아버리다.
disreputable	평판이 나쁜, 불명예스러운
             	~에 나쁜 영향을 미치는
disabuse	깨닫게 하다.
L54
disavow		부인, 거부하다.
disconsolate	불행한, 슬픈
discordant	일치하지 않는, 불협화음의
discursive	산만한, 추론적인
dispassionate	냉정한, 공평한
L55
disseminate	유포하다. 퍼뜨리다
distortion	왜곡, 오보
discomfit	좌절시키다. 당황케하다.
dissemble	감추다. 위장하다.
dissident	불찬성자

4주
L56
digress		본론에서 벗어나다.
disingenuous	불성실한, 부정직한, 음흉한
disparity		차등, 부등
disquisition	논문, 논술, 연구
dissimulate	시치미떼다.
L57
empower	권력을 부여하다.
encompass	포함하다. 둘러싸다.
encounter	우연히 만나다. 마주치다.
           	n만남, 충돌, 대결
emblem		상징, 표상
enchant		매혹하다. 마법을 걸다.
L58
entreat		간청, 탄원하다.
embargo	통상금지, 금지
         	v금지하다.
embody		구체화하다. 포함하다.
encroach	침해, 침입하다.
endow		기부하다. 타고나다.
L59
engross		열중하게 하다. 몰두하게 하다.
enmity		적개심, 증오심, 증오, 적의
ensue		잇따라 일어나다
entail		수반하다. 필요하게 하다.
enlightened	계몽된, 교화된, 진보된
L60
envoy		외교사절, 특사
encumber	방해하다. 빚을 지우다. 
          	~으로 부담이 되다. 
enjoin		명령, 재촉, 금지하다.
embellish	아름답게 장식하다.
encomium	찬사, 칭찬
L61
engender	발생시키다. 유발하다. 일으키다.
entrench	참호를 지키다. 확립하다.
empathy		공감, 감정이입
empirical	경험의, 경험적인
enclave		고립된 장소
L62
emit		발산, 발생하다. 신호를 보내다.
enumerate	열거하다.
evoke		불러내다. 환기시키다.
exalt		찬양하다. 기쁘게 하다.
expend		소비하다. 소모하다.
L63
expressly	명백하게, 솔직히, 특별히
extinct		사멸한, 멸종한
extort		강요, 강탈하다. 빼앗다.
eject		내쫓다. 추방, 배출하다.
elongate	길게하다. 잡아늘리다.
L64
eradicate	뿌리뽑다. 근절하다. 박멸하다.
erode		파먹다. 침식, 
		부식하다. 쇠퇴케 하다.
evolve		서서히 발전, 변화, 진화하다.
eclipse		해식, 빛을 잃음
       		v무색하게 하다. 능가하다.
efface		문질러 없애다. 소멸시키다. 
L65
elude		모면하다. 벗어나다. 회피하다.
emancipate	(노예등) 해방하다.
eminent		뛰어난, 두드러진
exodus		탈출, 퇴거
exorbitant	과대한, 터무니없는, 부당한
L66
expedient	편리한, 편의의
          	n수단, 임기조치
exposition	박람회, 전람회, 상술
expulsion	추방, 축출, 제적
extensive	광대한, 해박한
exterminate	박멸하다. 전멸시키다. 
L67
edict		포고, 명령, 법령
elated		의기양양한, 우쭐대는
elucidate	설명하다. 밝히다. 명백히 하다.
exemplary	모범적인, 훌륭한, 경고가 되는
explicit		명백한, 분명한, 숨김없는
L68
expound	상세히 설명하다. 
extant		현존하는
extol		칭한, 격찬하다.
exult		기뻐 날뛰다.
efficacious	유효한, 효험 있는
L69
egregious	지독한, 특출 난, 터무니없는
elicit		이끌어내다. 유도해내다.
erudite		박식한
evanescent	사라지기 쉬운, 덧없는
excise		삭제하다. 잘라내다.
L70
exhilarate	원기를 돋구다. 유쾌하게 하다.
exhort		타이르다. 훈계하다. 권하다.
expedite		진척시키다. 촉진하다.
expiate		속죄하다.
expurgate	삭제하다.
L71
extenuate	경감하다.
extricate		구출, 해방하다.
ebullient		열광한, 원기 왕성한
eclectic		절충의
effigy		초상, 인형, 모형
L72
effrontery	뻔뻔스러움
emanate	발산하다.
emend		교정, 수정하다.
enervate		쇠약하게 하다. 
         	a기운 없는, 힘없는
evince		나타내다. 보이다.
L73
exigency	긴급사태
effete		지친, 쇠퇴한
effusive		심정을 토로하는, 넘쳐 흐르는
emolument	보수, 봉급
execrable	극악무도한, 지독한
L74
illicit		해가되지 않은
illusion		환영, 환상, 착각, 망상
immense	끝없는, 막대한, 훌륭한, 멋진
immerse		담그다. 몰두시키다.
immobile	부동의
L75
impact		강한 인상, 영향, 충격
      		v꽉 채워넣다. 충돌하다.
impassable	통과할 수 없는
implement	도구, 연장
incalculable	헤아릴 수 없는, 막대한
incomprehensible	이해할 수 없는
L76
indisputable	논의의 여지가 없는, 명백한
induce		유발, 귀납하다. 
		설득하여~하게 하다.
inept		부적당한, 서투른, 무능한
ingenuity	영리함, 재능, 창작력
ingrained	뿌리깊이 밴, 철저한
L77
ingratitude	배은망덕
inhabitant	거주자
initiative		선도, 주도권, 솔선
innovation	혁신
instantaneous	즉석의, 순간적인
L78
intangible	무형의
intensive	강력한, 집중적인, 철저한
intimidate	협박하다.
invoke		호소, 간원하다.
imminent	긴급한, 절박한
L79
impartial		공평한
implore		대원, 탄원하다.
impostor	사기꾼
incentive	동기, 유인, 자극
indifference	무관심, 냉담
L80
indispensable	필수불가결한
indisposed	싫은, 내키지 않는
infamous	악명높은
inflammable	가연성의 노여움을 잘 타는
inflate		부풀리다. 우쭐하게 하다.

5주
L81
inflict		고통을 주다.
ingredient	성분, 요소, 재료
innumerable	무수한
inquiry		문의, 연구, 탐구, 심문, 조사
insubordinate	반항적인
L82
interminable	끝없는, 무궁한
impart		알리다. 전하다.
impediment	방해, 장애
impending	절박한, 임박한
imperative	긴요한, 필수적인, 명령적인
L83
impunity		처벌되지 않음, 무사
inaudible	알아들을 수 없는
incognito	신분을 감춘, 익명의
indiscriminate	무차별의, 난잡한
infinite		끝없는, 무수한, 막대한 
        	n무한자, 조물주, 신
L84
instigate		선동하다.
instill		주입하다.
intrigue		음모를 꾸미다 n밀애, 음모
invalidate	무효로 하다.
illegible		알아볼 수 없는 
L85
immortal	죽지않는  n불사신
immunity	면역, 면제
impair		손상하다. 약화시키다.
impel		몰아내다. 재촉하다. 추진시키다.
imply		의미, 암시, 함축, 내포하다.
L86
impoverish	가난하게 하다. 허약하게 하다.
improvise	임시변통으로 마련하다. 
inadequate	부적당한, 불충분한
incessant	끊임없는, 부단한
incinerate	소각하다.
L87
incite		선동하다. 자극하다.
incorrigible	상습적인, 고질적인
indicative	나타내는, 암시하는
inquisitive	호기심 많은
inscribe		쓰다. 적다.
L88
insinuate	넌지시 빗대어 말하다.
institute		협회, 의회
         	v제정하다. 설립하다.
intolerable	참을 수 없는
intrepid		대담한
intricate		뒤얽힌, 복잡한
L89
inundate	침수시키다. 범람시키다.
invariable	불변의 
invincible	무적의
irreverent	불손한, 불경한
imbibe		마시다. 섭취하다. 받아들이다.
L90
impervious	영향받지 않는, 무감동한
impetus		원동력, 추진력
implacable	무자비한
indemnity	손해배상
infallible		실패 않는, 확실한
L91
ingenuous	순진한, 개방적인, 꾸밈없는
innocuous	무해한, 의도가 없는
inopportune	부적당한
insidious	교활한
integrity		성실, 정직, 완전
L92
inveterate	뿌리 깊은, 고질적인
invulnerable	불사신의
irrelevant	부적절한, 상관없는
ignoble		비열한, 천한
immutable	불변의
L93
impassive	무감동의
imperious	당당한, 오만한, 절박한
impromptu	준비없는, 즉석에서
impugn		비난, 반박, 공격하다.
inadvertent	부주의한
L94
inanimate	생명이 없는, 따분한
inauspicious	불길한
inception	시작, 개시, 발단
incisive		날카로운, 신랄한, 민감한
inconsequential	일관성이 없는, 사소한
L95
incontrovertible	논쟁의 여지가 없는
incriminate	죄를 지우다.
inculcate	주입시키다.
infer		추론, 암시하다.
infirmity		허약, 병
L96
infraction	위반행위
ingratiate	비위맞추다.
inimical		적의가 있는, 해로운
inscrutable	불가사의한
insurgent	반역하는 n폭도
L97
intemperate	무절제한
invective	독설, 저주, 악담
irresolute	우유부단한, 망설이는
irrevocable	최종적인
ignominious	수치스러운
L98
impecunious	돈이 없는
imperturbable	동요하지 않는, 냉정한
importune	졸라대다
improvident	선견지명이 없는, 낭비적인
increment	이윤, 이익, 증가
L99
incumbent	재직자, 현직자
           	a기대는, 의지하는
indictment	기소, 고발
indubitable	확실한
inexorable	무정한, 냉혹한
iniquity		부정, 사악
L100
innate		타고난, 천부의
inordinate	과도한, 지나친
insatiable	탐욕스러운
intractable	고집센, 다루기 힘든
invidious	불쾌한
L101
irrefutable	반박할 수 없는
irreparable	고칠 수 없는
immaculate	순수한, 흠없는, 깨끗한, 완벽한
immolate	제물로서 죽이다.
immure		감금하다. 가두다
L102
impasse·	막다름, 난국, 곤경
incubus		악몽
ineffable	형언할 수 없는
ineluctable	피할 수 없는
inhibit		방해하다. 억제하다. 금하다.
L103
intercept	가로채다. 붙잡다.
interrupt		중단시키다. 가로막다. 방해하다.
intellectual	지적인, 지능적인
enterprising	기업심이 왕성한, 진취적인
intervene	사이에 끼어들다. 간섭하다.
L104
intermediary	중개자, 조정자 a중개하는
interrogate	심문하다. 
intercede	조정, 중재하다. 탄원, 청원하다.
intersect	가로지르다. 교차하다.
intermittent	간헐적인
L105
malady		병, 질병
malignant	치명적인, 유해한, 악의 있는
malnutrition	영양실조 
maltreat		혹사하다. 학대하다.
malevolent	악의 있는


6주
L106
malefactor	범인, 죄인, 악인
malediction	저주, 악담
malfeasance	부정행위
maladroit	솜씨없는, 서투른
malcontent	불만스러운, 반항적인
L107
officiate		직무를 행하다. 사회하다.
oppress		압박, 억압하다. 답답하게 하다.
obliterate	흔적을 없애다. 말살하다.
obese		매우 뚱뚱한
obligate		묶어두다. 속박하다.
L108
obnoxious	아주 싫은, 몹시 불쾌한
obviate		위험을 없애다. 제거하다.
officious	참견하는
obdurate	완고한, 고집센
occult		신비한, 초자연적인
L109
opportune	시기 적절한
ostensible	표면상의 
ostentatious	화려한, 현란한, 과시하는
obeisance	존경, 복종
obscene	외설적인, 음란한, 추잡한
L110
obsequious	아첨하는, 알랑거리는
opprobrium	불명예, 멸시, 비난
obloquy		비방, 욕설
obsession	강박관념
obtrude		강요, 강제하다.
L111
parody		패러디
paradox		역설
parasite		기생충
parable		우화, 비유
parallelism	평행, 대등, 유사, 비교
L112
paramount	최고의, 지상의, 탁월한
paragon		모범, 본보기
paraphrase	의역 v의해하다. 쉬게 바꿔쓰다
paroxysm	분노, 발작
parameter	조변수
L113
persevere	참다. 견디다, 고집하다.
pertain		속하다. 관계, 
		적합하다. 어울리다.
perjury		위증
perpetual	영구의 영속하는, 계속적인
persist		고집, 주장, 지속, 존속하다.
L114
pervade		고루 퍼지다. 
		만연하다. 스며들다.
persecute	박해하다. 괴롭히다.
perspective	전망, 시각, 원근법
perturb		불안하게 하다.
peruse		정독하다.
L115
perceive		지각, 감지, 인식, 이해하다.
perennial	끊이지 않는, 다년생의
perverse		외고집의, 사악한,
		 잘못된, 그릇된
permeate	스며들다. 침투하다. 
		고루 퍼지다.
pernicious	해로운, 유해한, 치명적인
L116
peremptory	독단적인, 강제적인, 거만한
perfunctory	형식적인
perspicacious	이해가 빠른 예민한, 총명한
pertinacious	완고한, 집요한
perfidious	배반하는, 불신의, 불성실한
L117
precaution	조심, 경계, 예방
prevail		우세하다. 이기다. 성행하다.
predecessor	전임자, 선조
premature	조숙한, 시기상조의
prescribe	규정하다. 명하다.
		 약을 처방하다.
L118
presume	추정하다. 감히 ~하다. 
         	오용, 악용하다.
preview		시사, 시연
preclude	막다. 방해, 제외하다.
predominant	뛰어난, 탁월한, 지배적인, 
             	우세한, 현저한
preamble	서문, 전문

L119
precipice	절벽, 벼랑, 위기
preferment	승진, 승급, 고위
preposterous	상식을 벗어난, 터무니 없는
precedent	전례, 판례
predicament	곤경, 궁지
L120
premeditated	미리 생각한, 계획적인
pretext		구실, 핑계
precept		교훈, 가르침
precocious	조숙한
predilection	편애
L121
premonition	예간, 예고, 전조
prerogative	특권, 대권
pretentious	자부하는, 뽑내는, 과장된
precursor	전조, 예고, 선구자
preempt		기선을 제압하다. 선취하다.
L122
prefatory	서문의, 머리말의
presage		예고, 예언, 예감하다. n 
presentiment	예감, 육감
prestigious	유명한, 명성있는
prescience	예지, 선견
L123
prosecute	기소, 고발하다.
procure		얻다. 획득, 야기, 초래하다.
proficient	능숙한, 숙달된
prolong		연장하다. 늘리다.
prominent	탁월한, 저명한, 돌출한
L124
prudent		신중한, 조심스러운, 현명한
proclaim	포고, 선언하다. 
		나타내다. 보이다
prodigal		낭비하는, 방탕한, 풍부한
prodigious	거대한, 막대한, 비범한
promontory	곶, 갑(언덕)
L125
profuse		매우 많은, 풍부한, 방비하는
proponent	제안자
profess		공언, 자처, 주장, 직업으로 하다.
protrude		밀어내다. 내밀다.
provoke		성나게 하다. 
		유발시키다. 일으키다
L126
prognosticate	예언, 예측하다.
prolific		다산의, 다작의, 비옥한, 풍부한
propensity	경향, 성벽, 버릇
proffer		제공, 제의하다.
propitious	순조로운, 유리한, 선의의
L127
proclivity	경향, 성벽, 기질
proscribe	급지, 추방하다. 박탈하다.
protege		피보호자
purport		의미, 취지, 요지
        	v의미하다. 주장하다. 칭하다.
purview		범위, 이해, 조항
L128
recede		물러나다. 토각하다.
reimburse	상환, 변상, 배상하다.
reminisce	추억에 잠기다.
replica		복사, 모사
responsive	대답하는, 응하는
L129
restrict		제한, 구속, 속박, 한정하다.
revoke		철회, 폐지, 취소하다.
recompense	보답하다. 갚다.
reinforce	강화, 보강하다.
remnant		나머지, 잔여
L130
renovate	수리, 보수하다. 새롭게 하다.
reputable	평판이 좋은, 존경할 만한
resentment	분개, 분노, 원한
resolution	해결, 해답, 분해, 결심, 결의
retard		방해하다. 지체하다.
L131
revive		부활하다. 소생하다.
recipient	수령인, 수상자 a수령하는, 받는
recluse		은둔자 a은둔의
recourse	의지, 의뢰
rehabilitate	복귀시키다. 복원하다.
            	명예를 회복시키다.
L132
relevant		관계가 있는, 적절한, 요령있는
residue		나머지, 잔여
retentive		보유하는, 기억이 좋은
revert		되돌아가다. 복귀하다.
rejuvenate	활기 띠게 하다.
L133
relentless	사정없는, 무자비한, 냉혹한
render		보답하다. 제공하다.
       		연출하다. 번역, 표현하다.
replenish	다시 채우다.
reprieve		집행유예, 일시적 중지
         	v 일시 구제하다.
repugnant	비위에 거슬리는, 불쾌한, 반대의
L134
retractable	취소할 수 있는, 움츠릴 수 있는
revile		욕하다. 욕설하다.
receptive	잘 받아들이는, 감수성이 예민한
reiterate		되풀이하다. 반복하다.
remiss		태만한, 부주의한, 무기력한
L135
renegade	배반자  a배반의
renounce	포기, 부인하다.
repellent		물리치는, 불쾌한, 싫은
repose		휴식, 수면, 침착, 평정
reprehensible	비난할 만한
L136
repress		억누르다. 억제, 저지하다.
reprisal		앙갚음, 보복
rescind		폐지하다. 무효로 하다.
respite		휴식, 연기, 유예
reticent		과묵한, 말이 적은
L137
retribution	보답, 응보, 보복
recapitulate	되풀이하여 말하다.
redoubtable	무서운
redundant	여분의, 과다한
relegate		지위를 떨어뜨리다.
L138
remit		송금, 용서, 면제, 완화
		환송하다.
remonstrate	항의, 충고하다.
reprove		비난하다.
repudiate	의절, 부인, 반박, 거부하다.
requisite		필수조건 a필요한, 필수의
L139
resilient		탄력있는, 쾌활한
restitution	반환, 배상
retrench		긴축, 절약하다.
recant		취소, 철회하다.
reconnaissance	정찰, 수색, 답사
L140
recrimination	맞고소
recumbent	기댄, 태만한
redolent		향기로운, 생각나게 하는
refulgent	빛나는, 찬란한
replete		가득찬, 충분한, 포만한


7주
L141
rapport		친밀한 관계, 동의, 일치
refractory	다루기 어려운, 고집센, 난치의
remand		재구속하다. 반송하다. n
repartee		재치있는 대답
resplendent	눈부신, 찬란한
L142
submissive	복종하는, 순종하는, 유순한
subordinate	a) 종속적인, 하위의
            	n) 하위자, 부하
            	v) 경시하다. 종속시키다.
subsequent	후속적인 
suffrage		투표권, 선거권, 투표, 찬성
supplement	보충하다.
L143
substantial	실질적인, 튼튼한, 
           	다량의 상당한
sustain		지탱, 양육, 확인, 인정하다.
subjugate	복종시키다. 정복하다.
succumb	굴복하다. 넘어가다. 죽다.
supplant		대신하다.
L144
successive	잇따른, 계속적인, 연속하는
suppress	진압, 억압, 억제하다. 
          	은폐하다. 감추다.
subservient	도움이 되는, 비굴한
subsidiary	보조의 종속적인
succinct		간결한
L145
supplicate	탄원, 간청하다.
supposition	상상, 가정, 추측
surreptitious	은밀한, 비밀의
susceptible	영향받기 쉬운, 움직이기 쉬운
           	민감한, 혀용하는, ~이 가능한
subsist		존재, 존속하다. 
L146
supersede	대신, 대체하다.
surplus		나머지, 잔여, 잉여
        	a나머지의, 잉여의
surmount	극복하다. ~의 위에 놓다, 앉다.
insuperable	극복할 수 없는
supercilious	거만한
L147
superficial	표면의, 피상적인
surfeit		과다, 과식, 과음, 식상
       		v 물리다. 과음, 식상하다.
surmise		추측, 짐작하다.
surveillance	감시, 감독
supervene	잇따라 일어나다.
L148
transform	변형시키다. 바꾸다.
transgress	넘다. 어기다.
transmit		보내다. 송신하다. 전하다. 
transparent	투명한, 비치는, 명료한
trespass		침입, 침해하다. 죄를 범하다.
L149
transition	과도, 과도기, 변화, 변천
tranquility	평정, 평온
transpire	밝혀지다. 알려지다. 발산하다.
transcend	추월, 능가하다.
transcribe	베껴쓰다. 방송, 편곡하다.
L150
transient	일시적인, 잠시의, 덧없는
transmute	변화시키다.
travesty		익살화, 희화화
         	v 우습게 만들다.
intransigent	비타협적인
            	n비타협자
traduce		중상모략 하다.
L151
barrage		연발, 역속, 둑, 보
heritage		유산
ravage		파괴, 황폐 v약탈하다.
bondage	노예 상태, 속박, 감금
salvage		해난구조 v구조, 인양하다.
L152
carnage		살육, 대량학살
pillage		약탈, 강탈  v약탈, 강탈하다.
verbiage		군말이 많음
envisage	상상하다.
mirage		신기루, 환상
L153
fidelity		충실, 충성, 성실, 정확
controversy	논쟁
levity		경솔, 경박
longevity	장수
nonentity	상상물
L154
proximity	근접
brevity		간결
animosity	증오, 증오심, 악의 반감
antipathy	강한반감
equanimity	평온, 평정
L155
acuity		예민, 격렬, 신랄
amenity		쾌적함, 즐거움, 예의
celerity		신속, 민첩
credibility	신용도, 신뢰성
lethargy		혼수상태, 무기력
L156
propriety	교양, 예절
dichotomy	양분, 분열
hierarchy	계급조직, 서열, 위계질서
logomachy	언쟁
probity		강직, 청렴, 고결
L157
audition		오디션
caption		제목, 자막 v표제를 달다
misapprehension		오해
partition		구분, 분배
         	v구분하다. 분배하다.
agitation	흥분, 동요, 불안, 토론, 
		논쟁, 혼란
L158
oration		연설, 식사
seclusion	격리, 은퇴
jurisdiction	사법권, 재판권
oblivion		망각, 무의식
altercation	언쟁
L159
intimation	암시, 발표, 통지
repercussion	간접적 영향, 반동
liaison		섭외, 연락, 간통
lucubration	야간공부
volition		의지, 결의, 결단
L160
amiable		친절한, 상냥한
perishable	썩기 쉬운, 시들기 쉬운 n
variable		변하기 쉬운, 일정치 않은 
		n 변수
docile		유순한
fallible		틀리기 쉬운
L161
fertile		상상력이 풍부한, 산출력이 많은
inimitable	흉내낼 수 없는
legible		알아보기 쉬운
notable		현저한, 저명한 n 저명인사
portable		휴대할 수 있는, 이용가능한

L162
durable		오래 견디는, 튼튼한
        	n 내구재, 소비재
plausible	그럴듯한
servile		아첨하는, 노예의, 추종하는
veritable		진실의, 참된
versatile		다재다능한
L163
amicable	우호적인, 친화적인
facile		수월한, 유창한
indelible		잊을 수 없는,
		치욕을 씻을 길 없는
indomitable	불굴의, 완강한
negligible	하찮은, 사소한
L164
pliable		고분고분한
tangible		명확한, 명백한, 실제적인 현실의
voluble		수다스러운, 유창한, 회전성의
censurable	비난할 만한
culpable		비난할 만할, 유죄의
L165
equitable	공정한, 정당한
palpable		뚜렷한, 명백한
mutable		변하기 쉬운, 변덕스러운
tenable		견딜 수 있는
impeccable	결점없는
L166
celestial		하늘의, 천국의
factual		사실상의, 실제의
global		지구의, 세계적인
martial		전쟁의, 용맹한
mortal		죽어야 할 운명의, 치명적인
       		지긋지긋한  n인간
L167
optional		임의의, 선택의
beneficial	유익한
maternal	어머니의
partial		부분적인, 일부분의, 불공평한
paternal		아버지의 
L168
regal		국왕의, 장엄한, 당당한
rural		시골의
trivial		하찮은, 사소한, 평범한, 경박한
vital		중요한, 생명의, 치명적인 n급소
genial		온화한, 따뜻한, 친절한,사교적인
L169
penal		형벌의
cordial		진심에서의
crucial		결정적인, 중대한,
		엄격한, 어려운
colossal		거대한, 굉장한
ephemeral	하루밖에 안가는, 덧없는
L170
nocturnal	밤의, 야행성의
nominal		명목상의, 하찮은
noncommittal	어느 편에도 속하지 않는
banal		평범한, 진부한
primordial	원시의, 초생의


8주
L171
fluent		유창한
indigent		가난한, 빈곤한
radiant		빛나는, 밝은, 방사의 복사의
vigilant		경계하고 있는
fervent		뜨거운, 열렬한, 정열적인
L172
solvent		용해력이 있는 n 용매
dominant	지배적인, 유력한, 주요한, 주된 
dormant		잠복의, 잠자는
latent		잠재적인, 잠복의
militant		투쟁적인, 교전하고 있는
L173
vagrant		방랑하는, 변하기 쉬운
         	n 방랑자
belligerent	전쟁하는, 교전중의
           	n 교전국, 호전국
benevolent	자비심 많은, 친절한
indulgent	멋대로 하게 하는, 관대한
nonchalant	무관심한, 냉담한, 태연한
L174
omnipotent	전능의
omniscient	전지의 박식한
opulent		부유한, 풍부한
potent		유력한, 세력 있는, 효능 있는
salient		현저한, 두드러진, 돌출한 n
L175
somnolent	졸린, 거의 잠든
trenchant	날카로운, 통렬한, 뚜렷한
turbulent	난폭한, 무질서한, 소란스러운
beneficent	인정 많은, 친절한  
corpulent	뚱뚱한, 살찐, 육중한
L176
munificent	아낌없이 주는, 손이 큰
stringent	엄격한
preeminent	우수한, 탁월한
ambient		주위의
cognizant	알고 있는, 인지하는
L177
concomitant	동반하는, 부수적인 n 부수물
mordant		신랄한, 독설적인, 비꼬는
nascent		발생하려고 하는, 초기의
ambivalent	의미가 양립하는, 막 일어나는
clairvoyant	투시의, 통찰력이 있는 
L178
legendary	전설상의
mercenary	돈을 좋아하는 n 용병
arbitrary		임의의, 독단적인
auxiliary		보조의, 부의
salutary		심신에 유익한, 건전한, 이로운
L179
sedentary	일이 앉아서 하는, 오래 앉은
cursory		서두르는, 주의하지 않은
mandatory	위임된, 강제적인, 의무적인
plenary		무제한의, 완전한, 절대적인
visionary	환상, 공상적인, 가공의 n 공상가
L180
logical		이치에 맞는, 논리적인
mimic		흉내내는, 모방의
       		n 모방자 v 흉내내다. 조롱하다.
graphic		도표의, 사실적인, 생생한
methodical	질서 있는, 조직적인, 정연한
caustic		부식성의, 신랄한, 비꼬는
L181
autocratic	독재자의, 독재의
synthetic	종합의, 합성의, 인조의
altruistic		이타적인
axiomatic	공리의, 자명한
exotic		외래의, 색다른, 진기한
L182
hypothetical	가설의, 가정의
intrinsic		본질적인, 고유한, 내부의
politic		교활한, 국가의, 사려깊은
myopic		근시의
panegyric	찬사
L183
ecumenical	전반의, 보편적인
monolithic	획일적인
narcissistic	자기도취의
pragmatic	실제적인, 실용주의의
symptomatic	징후의
L184
ambiguous	애매한, 모호한
notorious	악명 높은
capacious	수용력이 큰, 널찍한
judicious	분별 있는
solicitous	걱정하는, 염려하는
L185
voracious	게걸스럽게 먹는, 탐욕스러운
auspicious	상서로운, 길조의
laborious	일이 고된, 공들인, 딱딱한
ambidextrous	매우 솜씨있는
chivalrous	존경할 만한, 기사도적인
L186
loquacious	말많은, 수다스러운
magnanimous	관대한
omnivorous	잡식성의
vivacious	활발한
vociferous	소란한
L187
voluminous	넉넉한, 다작의
circuitous	우회의
credulous	쉽게 믿는
fractious	까다로운, 다루기 힘든
gratuitous	무료의, 이유없는, 불필요한
L188
meritorious	칭찬할 만한
sanctimonious	경건한 체하는
seditious	선동적인
sententious	교훈적인
specious	허울 좋은, 실속 없는
L189
tortuous		비틀린, 불성실한, 솔직치 못한
cacophonous	불협화음의
captious		헐뜯는, 시비조의
gregarious	집단의, 사교적인
luminous	밝은, 명료한, 알기 쉬운
L190
sumptuous	값비싼, 사치한, 광장한, 훌륭한
diaphanous	투명한
indigenous	토착의, 고유한
mellifluous	달콤한
populous	인구가 조밀한
L191
formulate	공식화 하다.
generate	낳다. 산출하다. 초래하다.
manipulate	조작하다. 다루다. 조종하다.
migrate		이주하다.
motivate		~에 동기, 자극을 주다. 
		유발하다.
L192
prevaricate	속이다. 발뺌하다.
vacate		퇴거하다. 물러나다. 포기하다.
fluctuate	변동하다. 동요하다. 파동하다.
legitimate	합법의, 적법의, 정통의
literate		교양있는, 학식있는 n
L193
ultimate		최후의, 근본적인
capitulate	조건부로 항복하다.
habituate	습관들이다 익숙하게 하다.
mediate		조정, 중재하다.
ornate		화려하게 장식한
L194
escalate		증가, 발전, 격화, 강화, 
		확대시키다.
exonerate	면제하다. 무죄로 하다.
insulate		절연하다. 격리시키다.
terminate	끝내다. 
vindicate	입증하다. 변호하다.
L195
alienate		따돌리다. 멀리하다. 양도하다.
placate		달래다
segregate	분리, 격리하다. 차별대우하다.
stipulate		약정, 규정, 요구하다.
castigate	징계하다. 견책, 혹평하다.
L196
equivocate	얼버무리다.
expatiate	설명, 부연하다.
procrastinate	지연하다. 지체하다.
profligate	방탕한, 품행이 나쁜
satiate		만족시키다. 물리게 하다.
L197
simulate		~인 체하다. 가장하다.
articulate	분명한, v 분명히 말하다.
exacerbate	악화시키다.
promulgate	퍼뜨리다. 발표하다.
vacillate		망설이다. 흔들리다.
L198
debilitate	쇠약하게 하다.
modulate	조정, 조절하다. 변조하다.
obfuscate	어둡게 하다. 모호하게 하다.
          	당황케 하다. 혼란시키다.
propitiate	달래다. 위로하다.
reciprocate	주고받다.
L199
pacify		가라앉히다. 달래다.
clarify		해명하다. 
		명료하게 하다. 정화하다.
mortify		굴욕감을 느끼게 하다. 
        	억제, 극복하다.
ratify		실증, 확증하다.
verify		조사하다. 증명, 확인하다.
L200
gratify		기쁘게 하다. 만족시키다.
justify		정당화하다. 변명하다.
fortify		강하게 하다. 보강하다.
rectify		바로잡다. 개정, 교정하다.
signify		알리다. 나타내다 
		의미, 표시하다.
